****.*.....**..%%%.**.******.*.***.**..
*_?..*.##..*...%+%......**...*...*.*..*
*??....##....#.%%%...**....#%%%#......*
*??..#.##.#..#....**######.#%+%##..##.*
*....#....#..##....*#....#.#%%%##..#...
...*.##.###...#.#..*#.&?.#.#.......#.**
..**..#.#.....#.#...#.??.#....##.#....*
...........#....###.#....#.##.##.###.**
**.*.###.*.#.##..##.#..@.#.#...#.......
*....#.....#..#..##.##.%.#...#...#.###.
**.#....##.##.#.............####.#..#..
...#..#.##..#...##..*..*..*.#..........
.####.#.###.#..##..*..***.*...%%%.####.
......#..##.....#..*.**....*.#%+%.#....
*.######%%%.#.#...*.....***..#%%%.#.##.
*.......%+%##.##.*..***...*.###.###.##.
*.######%%%##.##..**...**.*.........##.
*........#.................**..**......
..***.*..##.####.####.#.**...*....***..
..*......##.#.........#...***..##...*..
..*_?.**....#.........#.#.......#.-?*..
..*??....#..#.........#.#.......#.??*..
..*??.*..##.#.........#.#.......#.??*..
..*...*%%%#.######.####.#.......#...*..
..***.*%+%#..........**.#.........***..
......*%%%##.*.*...*..*.#########......
......*......***.****...........#......

