****.*.....**......**.******.*.***.**..
*_?..*.##..*....+.......**...*...*.*..*
*??....##....#.......**....#...#......*
*??..#.##.#..#....**######.#.+.##..##.*
*....#....#..##....*#....#.#...##..#...
...*.##.###...#.#..*#.&?.#.#.......#.**
..**..#.#.....#.#...#.??.#....##.#....*
...........#....###.#....#.##.##.###.**
**.*.###.*.#.##..##.#..@.#.#...#.......
*....#.....#..#..##.##...#...#...#.###.
**.#....##.##.#.............####.#..#..
...#..#.##..#...##..*..*..*.#..........
.####.#.###.#..##..*..***.*.......####.
......#..##.....#..*.**....*.#.+..#....
*.######....#.#...*.....***..#....#.##.
*........+.##.##.*..***...*.###.###.##.
*.######...##.##..**...**.*.........##.
*........#.................**..**......
..***.*..##.####.####.#.**...*....***..
..*......##.#.........#...***..##...*..
..*_?.**....#.........#.#.......#.-?*..
..*??....#..#.........#.#.......#.??*..
..*??.*..##.#.........#.#.......#.??*..
..*...*...#.######.####.#.......#...*..
..***.*.+.#..........**.#.........***..
......*...##.*.*...*..*.#########......
......*......***.****...........#......
