****.*.....**......**.******.*.***.**..
*....*.##..*....+.......**...*...*.*..*
*......##....#.......**....#...#......*
*....#.##.#..#....**######.#.+.##..##.*
*....#....#..##....*#....#.#...##..#...
...*.##.###...#.#..*#.&?.#.#.......#.**
..**..#.#.....#.#...#.??.#....##.#....*
...........#....###.#^...#.##.##.###.**
**.*.###.*.#.##..##.#..@.#.#...#.......
*....#.....#..#..##.##...#...#...#.###.
**.#....##.##.#.............####.#..#..
...#..#.##..#...##..*..*..*.#..........
.####.#.###.#..##..*..***.*.......####.
......#..##.....#..*.**....*.#.+..#....
*.######....#.#...*.....***..#....#.##.
*........+.##.##.*..***...*.###.###.##.
*.######...##.##..**...**.*.........##.
*........#.................**..**......
..***.*..##.####.####.#.**...*....***..
..*......##.#.........#...***..##...*..
..*...**....#.........#.#.......#...*..
..*......#..#.........#.#.......#...*..
..*...*..##.#.........#.#.......#...*..
..*...*...#.######.####.#.......#...*..
..***.*.+.#..........**.#.........***..
......*...##.*.*...*..*.#########......
......*......***.****...........#......
