****.*.....**..%%%.**.******.*.***.**..
*/?..*.##..*...%+%......**...*...*.*..*
*??....##....#.%%%...**....#%%%#......*
*??..#.##.#..#....**######.#%+%##..##.*
*....#....#..##....*#....#.#%%%##..#...
...*.##.###...#.#..*#.&?.#.#.......#.**
..**..#.#.....#.#...#.??.#....##.#....*
...........#....###.#....#.##.##.###.**
**.*.###.*.#.##..##.#..@.#.#...#.......
*....#.....#..#..##.##.%.#...#...#.###.
**.#....##.##.#.............####.#..#..
...#..#.##..#...##..*..*..*.#..........
.####.#.###.#..##..*..***.*...%%%.####.
......#..##.....#..*.**......#%+%.#....
*.######%%%.#.#...*.....***..#%%%.#.##.
*.......%+%##.##....***...*.###.###.##.
*.######%%%##.##..**...**.*.........##.
*........#.................**..**......
..***.*..##.####.####.#.**........***..
..*......##.#.........#...***..##...*..
..*_?.**....#.........#.#.......#.-?*..
..*??....#..#.........#.#.......#.??*..
..*??.*..##.#.........#.#.......#.??*..
..*...*%%%#.######.####.#.......#...*..
..***.*%+%#..........**.#.........***..
......*%%%##.*.*...*..*.#########......
......*......***.****...........#......

